111111111111111111111111111111111111111111
010000S00100000000000000000000000000000001
01000000010000000000000000000000001001000111111111111111111111111111111
11111101000000000000000000000000001100000000000000000000000111100001
1000000000000000000000000001111110101111111111111111111110000111101
1111110000000000000000010000000000100001100000100000000000000000001
00000010000000000000000000000100001011000000001111111111111111111111
000000100000000000000000000000000010110000000001
000000100000000000000000000000000010110000000111
111111000000000000000000000000010010000000001
100011100000000000000001111110000010000000001
1000000000000000000000000000000000100000000001
1000000000000000000000000000000000100000000001
100000000000000000000000000000000010000000001
10000000000000000000000000000000001000000001
1000000000000000000000000000000000000000001
1111111111111111111111111111111111111111111