111111111111111111111111111111111111111111
10000S001000000000000000000000000000000001
100000001000000000000000000000000000100001
101000001000000000000000000000000000010001
111111110000000000000000001111110000001001
10000000000000000000000100000000000000011
100000000000000000000001000000100000000011
100000000000000000000000000000100000000001
1000000000000000000000000000001000000000001
10000000000000000000000000000010000000000001
100011122222222222111111111110000000000000001
1000000000000000000000000000000000000000000001
1000000000000000000000000000000000000000000001
100000000000000000000000000000000000000000001
10000000000000000000000000000000000000000001
1000000000000000000000000000000000000000001
100000000000000000000000000000000000000001
10000000000000000000000000000000000000001
1000000000000000000000000000000000000001
100000000000000000000000000000000000001
10000000000000000000000000000000000001
1000000000000000000000000000000000001
100000000000000000000000000000000001
10000000000000000000000000000000001
1000000000000000000000000000000001
1000000000000000000000000000000010000000000000
10000000000000000000000000000001
1000000000000000000000000000001
100000000000000000000000000001
10000000000000000000000000001
1000000000000000000000000001
1000000000000000000000000001
100000000000000000000000011000000000000000000
1000000000000000000000000011111111111111111111
1000000000000000000000000000000000000000000001
1000000000000000000000000000000000000000000001
1000000000000000000000000000000000000000000001
1000000000000000000000000000000000000000000001
1000000000000000000000000000000000000000000001
1000000000000000000000000000000000000000000001
1000000000000000000000000000000000000000000001
1000000000000000000000000000000000000000000001
1000000000000000000000000000000000000000000001
1000000000000000000000000000000000000000000001
1000000000000000000000000000000000000000000001
1000000000000000000000000000000000000000000001
1000000000000000000000000000000000000000000001
1000000000000000000000000000000000000000000001
1000000000000000000000000000000000000000000001
1000000000000000000000000000000000000000000001
1000000000000000000000000000000000000000000001
1000000000000000000000000000000000000000000001
1000000000000000000000000000000000000000000001
1000000000000000000000000000000000000000000001
1000000000000000000000000000000000000000000001
1000000000000000000000000000000000000000000001
1000000000000000000000000000000000000000000001
1000000000000000000000000000000000000000000001
1000000000000000000000000000000000000000000001
1000000000000000000000000000000000000000000001
1000000000000000000000000000000000000000000001
1000000000000000000000000000000000000000000001
1000000000000000000000000000000000000000000001
11111111000000000000000011111111111111111111111
1111111100000000000000001111111111111
100000000000000000000000000000000001
1000000000000000000000000000000000001
10000000000000000000000000000000000001
100000000000000000000000000000000000001
1000000000000000000000000000000000000001
10000000000000000000000000000000000000001
100000000000000000000000000000000000000001
1000000000000000000000000000000000000000001
10000000000000000000000000000000000000000001
100000000000000000111111111110000000000000001
1000000000000000000000000000000000000000000001
1000000000000000000000000000000000000000000001
100000000000000000000000000000000000000000001
10000000000000000000000000000000000000000001
1000000000000000000000000000000000000000001
100000000000000000000000000000000000000001
10000000000000000000000000000000000000001
1000000000000000000000000000000000000001
100000000000000000000000000000000000001
10000000000000000000000000000000000001
1000000000000000000000000000000000001
100000000000000000000000000000000001
10000000000000000000000000000000001
1000000000000000000000000000000001
1000000000000000000000000000000010000000000000
10000000000000000000000000000001
1000000000000000000000000000001
100000000000000000000000000001
10000000000000000000000000001
1000000000000000000000000001
100000000000000000000000001
100000000000000000000000010000000000000000000
1000000000000000000000000011111111111111111111
1000000000000000000000000000000000000000000001
1000000000000000000000000000000000000000000001
1000000000000000000000000000000000000000000001
1000000000000000000000000000000000000000000001
1000000000000000000000000000000000000000000001
1000000000000000000000000000000000000000000001
1000000000000000000000000000000000000000000001
1000000000000000000000000000000000000000000001
1000000000000000000000000000000000000000000001
1000000000000000000000000000000000000000000001
1000000000000000000000000000000000000000000001
1000000000000000000000000000000000000000000001
1000000000000000000000000000000000000000000001
1000000000000000000000000000000000000000000001
1000000000000000000000000000000000000000000001
1000000000000000000000000000000000000000000001
1000000000000000000000000000000000000000000001
1000000000000000000000000000000000000000000001
1000000000000000000000000000000000000000000001
1000000000000000000000000000000000000000000001
1000000000000000000000000000000000000000000001
1000000000000000000000000000000000000000000001
1000000000000000000000000000000000000000000001
1000000000000000000000000000000000000000000001
1000000000000000000000000000000000000000000001
1000000000000000000000000000000000000000000001
1000000000000000000000000000000000000000000001
1000000000000000000000000000000000000000000001
1000000000000000000000000000000000000000000001
1111111111111100000000000000001111111111111111
111111111111110000000000000000111111
100000000000000000000000000000000001
1000000000000000000000000000000000001
10000000000000000000000000000000000001
100000000000000000000000000000000000001
1000000000000000000000000000000000000001
10000000000000000000000000000000000000001
100000000000000000000000000000000000000001
1000000000000000000000000000000000000000001
10000000000000000000000000000000000000000001
100000000000000000111111111110000000000000001
1000000000000000000000000000000000000000000001
1000000000000000000000000000000000000000000001
100000000000000000000000000000000000000000001
10000000000000000000000000000000000000000001
1000000000000000000000000000000000000000001
100000000000000000000000000000000000000001
10000000000000000000000000000000000000001
1000000000000000000000000000000000000001
100000000000000000000000000000000000001
10000000000000000000000000000000000001
1000000000000000000000000000000000001
100000000000000000000000000000000001
10000000000000000000000000000000001
1000000000000000000000000000000001
1000000000000000000000000000000010000000000000
10000000000000000000000000000001
1000000000000000000000000000001
100000000000000000000000000001
10000000000000000000000000001
1000000000000000000000000001
100000000000000000000000001
100000000000000000000000010000000000000000000
1000000000000000000000000011111111111111111111
1000000000000000000000000000000000000000000001
1000000000000000000000000000000000000000000001
1000000000000000000000000000000000000000000001
1000000000000000000000000000000000000000000001
1000000000000000000000000000000000000000000001
1000000000000000000000000000000000000000000001111
1000000000000000000000000000000000000000000000001
100000000000000000000000000000000000000000000111
100000000000000000000000000000000000000000000
1000000000000000000000000000000000000000000001
1000000000000000000000000000000000000000000001
1000000000000000000000000000000000000000000001
1000000000000000000000000000000000000000000001
1000000000000000000000000000000000000000000001
1000000000000000000000000000000000000000000001
1000000000000000000000000000000000000000000001
1000000000000000000000000000000000000000000001
1000000000000000000000000000000000000000000001
1000000000000000000000000000000000000000000001
1000000000000000000000000000000000000000000001
1000000000000000000000000000000000000000000001
1000000000000000000000000000000000000000000001
1000000000000000000000000000000000000000000001
1000000000000000000000000000000000000000000001
1000000000000000000000000000000000000000000001
1000000000000000000000000000000000000000000001
1000000000000000000000000000000000000000000001
1000000000000000000000000000000000000000000001
1000000000000000000000000000000000000000000001
1111111111111111111111111111111111111111111111