111111111111111111111111111111111111111111
010000000100000110000000000000000000000001
01200000010000011000000000000000001001000111111111111111111111111111111
1111110100000001100000000000000000110000000000000000000000010000001
1000000000000001100000000001111110101111111111111111111110000111101
1111110000000001100000010000000000100001100000100000000000000000001
10020010200000011000000000000100001011000000001111111111111111111111
100000000000000000000000000000000010110000000001
100000102000000110000000000000000010110000000111
111111000000000110000000000000010010000000001
100011100000000110000001111110000010000000001
1000000000000001100000000000000000100000000001
1000000000000001100000000000000000100000000001
100000000000000110000000000000000010000000001
10000000000000011000000000000000001000000001
10000000000000011000000000N00000000000000001
1111111111111111111111111111111111111111111