111111111111111111111111111111111111111111
10000S001000000000000000000000000000000001
10000000100000000000000000000000000010000111111111111111111111111111111
10111111100000000000000000000000000001000000000000000000000001111000001
10000000000000000000000000011111100000010111111111111111100001111000001
10000000000000000000000100000000000000011000000000000000100000000000001
10000000000000000000000100000010000000001100000000000000111111111111111
100000000000000000000000000000100000000001
1000000000000000000000000000001000000000001
10000000000000000000000000000010000000000001
100011122222222222111111111110000000000000001
1000000000000000000000000000000000000000000001
1000000000000000000000000000000000000000000001
100000000000000000000000000000000000000000001
10000000000000000000000000000000000000000001
1000000000000000000000000000000000000000001
1111111111111111111111111111111111111111111