
R 1000 750
F 100,100,214
C 135,197,214

EA ./textures/cat4.xpm
NO ./textures/cat1.xpm
SO ./textures/cat2.xpm
WE ./textures/cat3.xpm

S ./textures/barrel.xpm

1000000221
11111111111      100000000100000012121
10000002210000
1111101111
111110111111111111111111111111111111111111
010000000100000110000000000000000000000001
01200000010000011000000000000000001001000111111111111111111111111111111                     
1111110100000001100000000000000000110000000000000000000000010000001
1000000000000001100000000001111110101111111111111111111110000111101
1111110000000001100000010000000000100001100000100000000000000000001
10020010200000011000000000000100001011000000001111111111111111111111
10000000000       0000000000010000000000010110000000001
100000102000000110000000000000000010110000000111
111111000000000110000000000000010010000000001
100011100000E00000000021111110000010000000001      
1000000000000001100000000   000000000100000000001
1000000000000001100000000000000000100000000001
100000000000000110000000000000000010010000001
10000000000000011000000000000000001000000001
10000000000000011000000000000000001000000001
1111111111111111111111111111111111111111111
1111111111111111111111111111111111111111111