
R 1000 750
F 100,100,214
C 135,197,214

NO ./textures/texture1.xpm
SO ./textures/texture2.xpm
WE ./textures/texture3.xpm
EA ./textures/texture4.xpm

S ./textures/barrel.xpm

0000000000000000000000000000000000011111111111
11111111111111111111111111111111111100000000001
10000000000000000000000000000010000000020002001
100000000S0000000000000000000010000000000000001
10000000000000000000000000000000000000000000001
11111111111111111111111111111111111100000000001
11111111111111111111111111111111111100000000001
0000000000000000000000000000000000011111111111











